{
  "id": "world2-014",
  "title": "Little Square",
  "map": [
    "        ###   ",
    "        #.#   ",
    "        #.#   ",
    "#########.#   ",
    "#...      #   ",
    "#### $$$$ #   ",
    "   # $  $ #   ",
    "   # $ @$ #   ",
    "   # $$$$ ####",
    "   #      ...#",
    "   #.#########",
    "   #.#        ",
    "   #.#        ",
    "   ###        "
  ],
  "solution": ""
}