{
  "id": "world2-011",
  "title": "House",
  "map": [
    "##########",
    "#  ....  #",
    "#  $  $  #",
    "# $####$ #",
    "# @#  #  #",
    "####  ####"
  ],
  "solution": ""
}