{
  "id": "world2-003",
  "title": "Keep Pushing",
  "map": [
    "##########",
    "#   @    #",
    "#$ $ $ $ #",
    "#.$.$.$.$#",
    "#$.$.$.$.#",
    "#.$.$.$.$#",
    "# . . . .#",
    "##########"    
  ],
  "solution": ""
}