{
  "id": "world2-002",
  "title": "Double Room",
  "map": [
    "##########",
    "#        #",
    "# #$$$$# #",
    "# $....$ #",
    "# $....$ #",
    "# $....$ #",
    "# $....$ #",
    "# #$$$$# #",
    "#   @    #",
    "##########"    
  ],
  "solution": ""
}