{
  "id": "world2-007",
  "title": "Inside Out",
  "map": [
    "#########",
    "#.......#",
    "#.$ $ $ #",
    "#$ $ $ $#",
    "# $ @ $ #",
    "#$ $ $ $#",
    "# $ $ $.#",
    "#.......#",
    "#########"
  ],
  "solution": ""
}