{
  "id": "world2-005",
  "title": "Maze",
  "map": [
    "##############   ",
    "#  #  #   #  ####",
    "#  #  $   #     #",
    "#  # ##  #  ##$ #",
    "#  # ## $#  #  ##",
    "#... ##  #  #  # ",
    "#  # ##  ##$#  # ",
    "#... ##$##  ##$# ",
    "#  # ##  #  #  # ",
    "#  # ##  #  #  # ",
    "#  # ##  ##$#  # ",
    "#  # ##$##  ## # ",
    "#     #  #  ##$# ",
    "#  #  #  #  #  # ",
    "#... ##  ##$#  # ",
    "#  ####$##  #  # ",
    "#...# #      #$# ",
    "##### #  #   #@# ",
    "      ########## "
  ],
  "solution": ""
}