{
  "id": "world2-015",
  "title": "Huge Room",
  "map": [
    "################",
    "#             .#",
    "# $**$       $.#",
    "# $..$         #",
    "# $..$         #",
    "# $..$         #",
    "# $..$         #",
    "# $..$         #",
    "# $..$         #",
    "# $..$         #",
    "# $..$         #",
    "# $..$         #",
    "# $..$         #",
    "# $..$         #",
    "# $..$         #",
    "# $..$         #",
    "# $..$       $.#",
    "#@$..$        .#",
    "################"
  ],
  "solution": ""
}