{
  "id": "world2-009",
  "title": "Chinese Two",
  "map": [
    "#######",
    "#     #",
    "#     #",
    "#$$$$$#",
    "#.....#",
    "#.....#",
    "#$$$$$#",
    "#  @  #",
    "#######"
  ],
  "solution": ""
}