{
  "id": "world2-008",
  "title": "Stairs",
  "map": [
    "      #####",
    "     ##.  #",
    "    ##. $ #",
    "   ##. $$ #",
    "  ##. $$ .#",
    " ##. $$ .##",
    "##. $$ .## ",
    "#. $$ .##  ",
    "# $$ .##   ",
    "# $ .##    ",
    "#@ .##     ",
    "#####      "
  ],
  "solution": ""
}