{
  "id": "world2-013",
  "title": "Sword",
  "map": [
    "###########",
    "#      * .#",
    "#      *  #",
    "#******$**#",
    "#      * @#",
    "#      *  #",
    "###########"
  ],
  "solution": ""
}