{
  "id": "world2-016",
  "title": "Four Rooms",
  "map": [
    "#########",
    "#.  $  .#",
    "# .@$ . #",
    "#  .$.  #",
    "#$$$*$$$#",
    "#  .$.  #",
    "# . $ . #",
    "#.  $  .#",
    "#########"
  ],
  "solution": ""
}