{
  "id": "world4-007",
  "title": "Big Triangle",
  "map": [
    "           ###",
    "          ##.#",
    "         ##.*#",
    "        ##.$.#",
    "       ##.$ *#",
    "      ##.$ $.#",
    "     ##.$ $ *#",
    "    ##.$ $ $.#",
    "   ##.$ $ $ *#",
    "  ##.$ $ $ $.#",
    " ##.$ $ $ $ *#",
    "##.$ $ $ $ ###",
    "#+*........#  ",
    "############  "
  ],
  "solution": ""
}