{
  "id": "gen-1770292209337",
  "title": "Generated (10 pushes)",
  "map": [
    "##############",
    "#   #####    #",
    "# $ #   #    #",
    "# . #   #  $ #",
    "#   #####  . #",
    "#      . $@  #",
    "##############"
  ]
}