{
  "id": "world1-004",
  "title": "Narrow Corridor",
  "map": [
    "###########",
    "#   .     #",
    "# ### ### #",
    "# $   $ @ #",
    "# ### ### #",
    "#     .   #",
    "###########"
  ]
}
