{
  "id": "world1-007",
  "title": "Tunnel Logic",
  "map": [
    "#############",
    "#   .   .   #",
    "### ### ### #",
    "#   $   $   #",
    "# ### ### ###",
    "#     @     #",
    "#############"
  ]
}
