{
  "id": "world1-008",
  "title": "Split Paths",
  "map": [
    "#############",
    "# .   #   . #",
    "# ### # ### #",
    "#   $   $   #",
    "### ##### ###",
    "#     @     #",
    "#############"
  ]
}
