{
  "id": "world1-012",
  "title": "Three Sum v3",
  "map": [
    "######",
    "# @$.#",
    "# $$.#",
    "#  #.#",
    "#    #",
    "######"
  ]
}
