{
  "id": "world1-001",
  "title": "Intro 1",
  "map": [
    "########",
    "#  .   #",
    "#  $   #",
    "#  @   #",
    "#      #",
    "########"
  ]
}