{
  "id": "world1-010",
  "title": "Advanced Corridors",
  "map": [
    "#############",
    "# .   ###   #",
    "# ### # ### #",
    "#   $   $   #",
    "### ### # ###",
    "#     @     #",
    "#############"
  ]
}
