{
  "id": "gen-1770292114393",
  "title": "Generated (14 pushes)",
  "map": [
    "###############",
    "#      .      #",
    "#   #####     #",
    "#  $#   #  .  #",
    "#   #   # $   #",
    "#   #####   $@#",
    "#      .      #",
    "#             #",
    "###############"
  ]
}