{
  "id": "world1-005",
  "title": "Order Matters",
  "map": [
    "###########",
    "# .     . #",
    "# ### ### #",
    "#   $ $   #",
    "# ### ### #",
    "#     @   #",
    "###########"
  ]
}
