{
  "id": "world1-001",
  "title": "Hello World!",
  "map": [
    "##########",
    "####....##",
    "#  $$$$###",
    "#  @   ###",
    "##########"
  ]
}