{
  "id": "world1-011",
  "title": "Three Sum v2",
  "map": [
    "########",
    "#@     #",
    "# .$$. #",
    "# $..$ #",
    "# $..$ #",
    "# .$$. #",
    "#      #",
    "########"
  ]
}
