{
  "id": "world1-006",
  "title": "Trap Corners",
  "map": [
    "############",
    "# .      . #",
    "# ### ## ###",
    "# $   ##   #",
    "# ### ## ###",
    "#   @      #",
    "############"
  ]
}
