{
  "id": "world1-002",
  "title": "Intro 2",
  "map": [
    "#########",
    "#   .   #",
    "#  $$   #",
    "#   @   #",
    "#       #",
    "#########"
  ]
}