{
  "id": "world1-003",
  "title": "Corners matter",
  "map": [
    "###########",
    "#   #.    #",
    "#  $#$    #",
    "#  . @    #",
    "#         #",
    "###########"
  ]
}