{
  "id": "world3-016",
  "title": "Curly",
  "map": [
    "###########",
    "#         #",
    "# ******* #",
    "# *  @  * #",
    "# * **$ * #",
    "##* *   * #",
    "# * ***** #",
    "# *       #",
    "# ******. #",
    "#         #",
    "#    #    #",
    "###########"
  ],
  "solution": ""
}