{
  "id": "world3-001",
  "title": "H and Four",
  "map": [
    " #####   ",
    " #   ### ",
    "##.# #.##",
    "#..$ $..#",
    "## $$$ ##",
    "##$$ $$##",
    "#..$ $+.#",
    "##.$ #.##",
    " ###   # ",
    "   ##### "
  ],
  "solution": ""
}